+--+--+--+--+--+--+--+--+--+--+--+--+--+--+--+--+--+--+--+--+--+--+--+  +--+--+--+--+--+--+--+--+--+--+--+--+--+--+--+--+--+--+--+--+--+--+--+
|                 |     |                                      |        |        |              |              |                 |           |
+--+--+--+  +  +  +  +  +  +--+--+--+--+--+--+--+--+  +--+--+--+  +--+--+  +  +--+  +  +--+--+--+  +--+--+  +--+  +  +--+--+--+  +  +--+--+  +
|        |  |  |  |  |  |  |        |     |           |     |     |  |     |        |           |  |     |        |           |     |     |  |
+  +--+  +--+  +--+  +  +  +  +  +--+  +  +  +--+--+--+  +  +  +--+  +  +--+--+--+--+--+--+--+  +  +  +  +--+--+--+--+--+--+  +--+--+  +  +  +
|  |        |  |     |     |  |  |     |  |              |  |     |        |        |        |     |  |  |        |           |        |  |  |
+  +--+--+  +  +  +--+--+--+--+  +  +--+  +--+--+--+--+--+  +--+  +--+--+  +  +  +  +  +--+  +--+--+  +  +  +  +  +  +--+--+--+  +--+--+  +  +
|        |     |           |     |     |        |        |     |        |  |  |  |  |     |  |     |  |     |  |  |           |  |  |     |  |
+  +--+  +--+--+--+--+--+  +  +--+  +--+--+  +  +--+--+  +  +  +--+--+  +  +--+  +--+--+  +  +  +  +  +--+--+  +--+--+--+--+  +  +  +  +--+--+
|  |  |                 |  |     |  |        |           |  |        |  |     |        |  |     |  |  |     |  |              |     |        |
+  +  +--+--+--+--+  +--+  +  +  +  +  +--+--+--+--+--+  +  +--+  +--+  +--+  +--+--+  +  +--+--+  +  +--+  +  +  +--+--+--+--+--+  +--+--+  +
|     |              |     |  |     |  |     |        |  |     |  |     |  |  |        |        |  |  |     |  |  |              |  |     |  |
+--+  +  +--+  +--+--+  +--+  +--+--+  +  +  +--+  +--+  +--+  +--+  +--+  +  +  +--+--+--+--+  +  +  +  +--+  +  +  +--+--+--+  +  +  +  +  +
|  |  |  |     |     |     |        |     |     |        |     |     |  |     |  |     |     |  |  |  |     |  |     |        |     |  |  |  |
+  +  +  +  +--+  +  +--+  +  +--+--+--+--+--+  +--+--+--+  +  +  +--+  +  +--+  +  +  +  +  +  +  +  +--+  +  +--+--+--+--+  +--+--+--+  +  +
|     |  |  |     |     |  |  |        |        |     |     |  |  |  |     |        |     |     |           |                             |  |
+--+--+  +--+  +--+  +--+  +  +  +--+  +  +--+--+  +  +  +  +--+  +  +  +--+--+--+--+--+--+--+--+--+--+--+--+--+--+  +--+--+--+--+--+--+--+  +
|     |  |     |  |     |  |  |  |        |        |  |  |  |     |  |     |                       |                 |        |              |
+  +  +  +  +--+  +--+  +  +--+  +--+--+--+  +--+--+  +  +--+  +--+  +--+  +  +--+--+--+  +--+--+  +  +--+--+--+--+  +  +--+  +  +--+--+--+--+
|  |     |  |        |  |     |           |     |     |  |     |     |     |           |  |     |     |        |     |     |  |              |
+  +--+--+  +--+--+  +  +--+  +  +--+--+  +--+  +  +--+  +  +--+  +  +  +--+--+--+--+  +--+  +  +--+--+  +--+  +  +--+--+  +  +--+--+--+--+  +
|        |           |  |     |        |        |     |  |  |     |  |              |        |  |     |     |        |  |  |              |  |
+--+--+  +--+  +--+--+  +  +--+--+--+--+--+--+--+--+  +  +  +  +--+  +--+--+--+--+  +--+  +--+  +  +  +--+--+--+--+  +  +  +  +--+--+--+  +  +
|     |  |     |     |  |  |              |        |  |  |  |     |  |           |     |     |  |  |           |        |  |  |        |     |
+  +  +  +  +--+  +  +  +  +--+  +--+--+  +  +--+  +  +  +  +--+  +  +  +--+  +--+--+  +--+  +  +  +--+--+--+  +--+--+--+  +--+  +--+  +--+  +
|  |     |  |  |  |     |     |        |  |     |     |  |  |     |     |  |        |     |  |  |  |  |     |           |     |     |     |  |
+  +--+  +  +  +  +--+--+--+  +  +--+  +  +--+  +--+--+  +  +--+--+  +--+  +--+--+  +--+  +--+  +  +  +  +  +--+--+--+  +--+  +--+  +--+  +--+
|     |  |     |           |  |     |  |        |        |        |     |  |     |              |  |     |                    |     |  |     |
+--+  +--+--+  +--+--+--+  +  +--+  +  +--+--+--+  +--+--+--+--+  +--+  +  +  +  +--+--+--+--+  +  +--+--+  +--+--+--+--+--+  +  +--+  +--+  +
|     |     |  |     |     |  |     |  |           |              |  |  |     |  |           |  |        |           |     |  |  |        |  |
+  +--+  +  +  +--+  +  +--+  +--+--+  +  +--+--+--+  +--+--+--+--+  +  +--+--+  +  +--+--+  +--+--+--+  +--+--+--+--+  +  +--+  +--+  +--+  +
|        |  |        |                 |        |     |              |     |     |  |     |              |              |  |           |     |
+  +--+--+  +--+--+  +--+--+--+--+--+--+--+--+  +  +--+--+--+  +--+--+--+  +  +--+  +  +  +--+--+--+  +--+  +--+--+--+--+  +  +--+--+--+  +--+
|     |     |        |              |           |     |        |        |  |     |  |  |           |  |     |        |     |  |        |     |
+--+  +  +--+  +--+--+  +--+--+--+  +  +--+--+--+--+  +  +--+--+  +  +--+  +--+  +  +--+--+--+  +--+  +  +--+--+--+  +  +--+  +  +--+  +--+  +
|     |  |     |     |     |     |     |     |        |  |        |  |           |           |        |              |        |     |        |
+  +--+  +  +--+  +  +--+  +  +--+  +--+  +  +  +--+--+  +  +--+--+  +  +--+--+--+--+--+--+  +  +--+--+  +--+--+--+--+--+--+--+--+  +--+--+--+
|  |     |  |     |     |  |        |     |  |     |        |        |     |                 |  |        |                          |        |
+  +  +--+  +  +--+--+  +  +--+--+--+  +--+  +--+  +  +--+--+  +--+--+--+  +  +--+--+--+--+  +--+  +--+--+  +--+  +--+--+--+--+  +--+  +--+  +
|  |  |     |  |     |  |              |        |  |        |              |  |     |  |     |     |     |     |  |     |     |  |     |     |
+  +  +  +--+  +  +  +  +--+--+--+--+--+  +--+  +  +--+--+--+--+  +--+--+--+  +  +  +  +  +--+  +--+--+  +--+  +--+  +  +  +  +--+  +--+  +--+
|  |  |  |     |  |     |              |     |  |        |     |     |        |  |  |     |                 |        |     |     |  |  |     |
+  +  +  +  +--+  +--+--+  +  +--+--+--+--+  +--+--+--+  +  +  +--+--+  +--+--+  +  +--+  +  +--+--+--+--+--+--+--+--+  +--+--+  +  +  +--+  +
|  |  |  |  |     |        |  |           |           |  |  |     |     |        |     |  |  |                       |        |  |     |     |
+--+  +  +  +  +--+  +--+--+  +  +--+--+  +  +--+  +  +  +  +--+  +  +--+  +--+--+--+  +--+  +  +--+--+--+--+--+--+  +--+  +--+  +--+  +  +  +
|     |  |  |              |  |  |     |  |     |  |  |  |     |     |     |           |     |        |        |     |     |     |     |  |  |
+  +  +  +--+--+--+--+--+--+  +  +  +  +  +--+--+  +--+  +--+  +--+--+  +--+  +--+--+--+  +--+--+--+  +  +--+  +--+  +--+--+  +--+  +--+  +--+
|  |  |        |              |  |  |              |     |     |        |     |           |           |     |     |           |        |     |
+  +--+--+--+  +  +--+--+--+  +  +--+--+--+--+--+  +  +--+  +--+  +--+--+  +--+  +--+--+--+  +--+--+--+--+  +--+  +--+--+--+--+  +--+--+--+  +
|           |  |        |     |           |        |     |           |     |     |  |        |     |     |  |  |  |           |  |           |
+  +  +--+  +  +--+--+  +--+--+--+--+--+  +  +--+--+--+  +--+  +--+--+  +--+  +--+  +  +--+--+  +  +  +  +  +  +  +  +--+--+  +  +  +  +--+--+
|  |  |     |           |                 |           |     |  |        |     |     |           |     |  |     |     |     |     |  |  |     |
+  +  +--+--+  +--+--+--+  +--+--+--+--+--+--+--+--+--+--+  +--+  +--+--+  +--+  +  +--+--+--+--+--+--+  +--+  +--+--+  +  +--+--+  +--+  +  +
|  |           |           |                 |           |     |  |     |  |     |           |     |     |     |     |  |           |     |  |
+  +--+--+--+--+  +--+--+--+  +--+--+--+--+  +  +--+  +--+--+  +  +  +  +  +--+--+--+  +--+  +--+  +  +--+  +--+  +  +  +--+--+--+--+  +--+  +
|  |              |        |              |  |  |  |           |  |  |                 |           |  |     |     |  |  |              |  |  |
+--+  +--+--+--+--+  +--+  +--+  +--+--+--+  +  +  +--+--+--+--+  +  +--+--+--+--+--+--+--+--+--+--+  +  +--+--+--+  +  +  +--+--+--+--+  +  +
|     |     |        |     |     |           |  |     |        |        |                 |        |                 |  |  |              |  |
+  +--+  +  +  +--+--+  +--+  +--+  +--+--+--+  +  +  +  +  +--+  +--+--+  +--+--+--+--+  +  +--+  +--+--+--+  +--+--+  +  +  +--+--+--+  +  +
|        |        |     |        |        |     |  |     |     |  |     |        |           |              |  |        |  |     |        |  |
+  +--+--+--+--+--+  +--+  +--+--+  +--+  +  +--+--+--+--+--+  +  +  +  +--+--+  +--+--+--+--+--+--+--+--+  +--+  +--+--+  +--+--+  +--+--+  +
|     |           |  |     |     |     |  |                 |     |  |           |                 |              |        |     |  |        |
+--+--+  +--+--+  +  +  +--+  +  +--+--+  +--+--+--+--+--+  +--+--+  +--+--+--+--+  +--+--+  +--+  +--+--+--+--+--+  +--+--+  +  +  +  +--+--+
|     |     |  |  |  |     |  |              |     |     |        |        |        |     |     |              |     |        |  |  |  |     |
+  +  +--+  +  +  +  +--+  +  +--+--+--+--+  +  +--+  +  +--+--+  +--+  +  +  +--+--+  +  +--+--+--+--+--+--+  +  +--+  +--+--+  +  +  +  +  +
|  |        |           |  |     |  |           |     |        |     |  |           |  |              |        |  |     |     |     |     |  |
+  +--+  +--+--+--+--+  +  +--+  +  +  +--+--+--+  +--+  +--+--+--+  +  +--+--+--+--+  +--+--+--+--+  +  +--+  +  +--+  +  +  +--+--+--+--+  +
|     |  |           |  |  |     |     |  |        |     |        |  |        |     |     |        |     |     |  |     |  |                 |
+--+  +  +  +--+--+  +--+  +  +--+  +--+  +  +--+--+  +  +  +--+  +  +  +--+--+  +  +--+  +  +--+  +--+--+--+--+  +  +--+  +--+--+--+--+--+  +
|     |  |  |     |  |     |     |        |  |        |  |     |     |  |        |        |  |  |        |        |  |     |              |  |
+  +--+--+  +--+  +  +  +--+--+  +--+--+--+  +  +--+--+--+--+  +--+--+  +  +--+--+--+--+--+  +  +--+--+  +  +--+--+  +  +--+--+--+--+--+  +  +
|     |           |           |           |  |  |        |     |     |  |        |           |        |  |        |  |                 |  |  |
+--+  +  +--+--+--+--+--+--+  +--+--+  +  +  +  +  +--+  +  +--+  +  +--+  +--+  +  +--+--+--+--+  +  +  +--+--+  +  +--+--+--+--+--+  +  +  +
|     |     |        |        |     |  |  |  |     |     |     |  |     |  |     |     |           |  |        |        |           |  |     |
+  +--+  +--+  +--+  +--+--+  +  +  +--+  +  +--+--+  +--+--+  +  +--+  +--+  +--+--+  +  +--+  +--+--+--+  +  +--+--+  +--+--+--+  +  +--+--+
|  |     |     |  |        |  |  |        |  |        |        |  |           |     |  |     |  |           |  |                    |        |
+  +  +--+  +--+  +--+--+  +  +  +--+--+--+  +  +--+  +  +--+--+  +--+--+--+--+  +  +  +--+  +  +  +--+--+--+--+  +--+--+--+--+--+--+--+--+  +
|  |     |     |        |  |  |              |     |  |        |        |        |  |  |     |  |     |           |  |                       |
+  +--+  +--+  +--+  +  +  +--+--+--+--+--+--+  +  +--+--+--+  +--+  +  +  +--+--+  +  +--+--+  +--+  +  +--+--+--+  +  +--+  +--+--+--+--+  +
|           |     |  |  |                    |  |           |     |  |           |     |     |     |  |  |           |     |  |        |     |
+--+--+  +--+--+  +  +  +--+--+--+--+--+--+  +--+  +--+  +--+--+  +--+--+--+--+--+--+  +  +  +  +  +  +  +--+  +--+  +--+  +  +  +--+  +--+--+
|     |  |        |  |              |     |     |  |     |        |                 |     |  |  |  |  |     |  |  |     |  |  |     |        |
+  +  +--+  +  +--+--+--+  +--+  +--+  +  +--+  +  +  +--+  +--+--+  +  +--+--+--+  +--+--+  +--+  +  +--+  +  +  +--+  +  +--+--+  +--+--+  +
|  |        |  |        |     |        |        |  |  |     |  |     |  |     |           |        |           |        |  |              |  |
+  +--+--+--+--+  +--+  +--+--+--+--+--+--+  +--+--+  +  +--+  +  +  +--+  +  +--+--+--+  +--+--+--+--+--+--+--+--+--+--+  +  +--+--+--+--+  +
|     |           |     |                 |  |        |  |  |     |        |        |                             |        |  |     |        |
+  +  +  +--+--+--+  +--+  +--+--+--+--+  +  +--+  +--+  +  +  +--+--+--+--+--+--+  +--+  +--+--+--+  +--+--+--+  +  +--+  +  +  +  +  +--+--+
|  |              |     |        |     |  |        |     |     |     |           |     |  |     |     |        |     |     |  |  |  |        |
+--+--+--+--+--+--+--+  +--+--+  +--+  +  +--+--+--+  +--+  +--+  +  +  +--+--+  +  +  +--+  +  +--+--+  +--+  +--+--+--+  +  +--+  +--+--+  +
|                             |        |     |        |  |     |  |     |  |     |  |  |     |        |     |           |  |  |     |        |
+  +--+--+--+--+--+--+  +--+--+--+--+  +--+  +  +--+--+  +--+  +  +--+--+  +  +--+--+  +  +--+--+  +  +--+  +--+--+--+  +--+  +  +--+  +--+--+
|           |     |     |           |     |     |     |        |        |              |  |     |  |           |        |        |     |     |
+--+--+--+  +  +  +  +--+  +--+--+  +--+  +--+--+--+  +  +--+--+--+--+  +--+--+--+--+  +  +  +  +--+--+--+--+--+  +--+--+  +--+--+  +--+  +  +
|           |  |     |        |     |     |           |  |           |              |  |  |  |                    |        |        |     |  |
+  +--+--+  +--+--+--+  +--+--+  +--+  +--+--+--+  +--+  +--+  +--+--+--+--+--+  +  +--+  +  +--+--+--+--+--+--+  +  +--+--+  +  +--+  +--+  +
|  |        |           |        |     |           |     |     |     |        |  |  |     |           |     |     |     |     |  |     |  |  |
+  +--+--+--+  +--+--+--+  +  +--+  +--+  +--+--+--+  +--+  +--+  +  +  +--+  +--+  +  +--+--+--+  +  +  +  +--+--+  +--+  +  +--+  +--+  +  +
|        |     |        |  |  |     |              |     |  |     |  |  |        |        |     |  |     |     |     |     |  |     |     |  |
+  +--+  +  +--+--+  +--+  +  +  +--+--+  +--+--+  +--+  +  +  +--+  +  +--+--+  +--+--+--+  +  +--+--+--+--+  +  +--+  +  +--+  +--+--+  +  +
|     |  |        |  |     |  |        |  |           |  |     |     |     |  |              |                 |     |  |  |              |  |
+--+  +  +--+--+  +  +  +--+--+--+--+  +  +  +--+--+  +  +  +--+  +--+--+  +  +--+--+--+  +--+--+--+--+--+--+  +--+  +  +--+  +--+--+--+--+  +
|     |     |     |  |           |     |  |        |  |  |     |        |  |              |              |        |  |        |              |
+--+--+--+  +  +--+  +--+--+  +--+  +--+--+  +--+  +--+  +--+--+--+  +--+  +  +--+--+--+--+  +--+--+--+  +--+--+--+  +--+--+--+  +--+--+--+--+
|           |  |           |     |        |     |  |                 |     |              |     |  |     |                    |  |           |
+  +--+--+  +  +  +--+--+--+--+  +--+--+  +--+  +  +  +--+--+--+--+--+  +--+--+--+  +--+--+--+  +  +  +--+  +--+--+--+--+--+--+  +  +--+--+  +
|        |  |     |                    |     |  |        |              |     |     |        |     |     |  |                 |     |        |
+--+--+  +--+  +--+  +--+--+  +--+--+  +--+  +--+--+--+  +  +--+--+--+--+  +  +--+--+  +  +  +--+  +--+  +  +  +--+--+--+--+  +  +--+  +--+  +
|        |     |     |     |  |     |     |           |  |                 |     |     |  |     |  |  |     |     |     |     |  |  |  |     |
+  +--+--+  +--+  +--+  +  +--+  +  +--+--+--+--+--+  +--+  +--+--+  +--+--+--+  +  +--+  +--+--+  +  +--+--+--+  +  +--+  +--+  +  +  +--+  +
|        |  |     |     |     |  |                 |     |  |     |        |  |  |  |     |        |           |  |        |        |     |  |
+  +--+  +  +  +--+  +--+--+  +  +--+--+--+  +--+--+--+  +--+  +  +--+--+  +  +  +  +  +--+  +--+--+  +--+--+--+  +  +--+--+--+--+--+  +  +--+
|     |     |  |        |     |  |        |  |           |     |     |     |  |  |  |     |        |     |        |  |              |  |     |
+--+  +--+--+  +  +--+--+  +--+  +  +--+--+  +  +--+--+--+  +--+--+  +  +--+  +  +  +--+  +--+--+  +--+  +  +--+--+  +--+--+  +--+  +--+--+  +
|        |     |  |        |     |        |     |              |     |        |     |     |              |  |     |        |     |           |
+--+--+--+  +--+  +  +--+--+  +--+  +--+  +--+--+  +--+--+--+  +--+  +--+--+--+--+--+  +--+  +--+--+--+--+  +  +  +--+--+  +--+  +--+--+--+--+
|           |     |     |     |        |           |        |     |     |           |           |        |     |        |     |              |
+  +--+--+--+  +--+--+  +  +--+--+--+--+--+--+--+--+  +--+  +--+  +--+  +  +--+--+  +--+--+--+--+  +--+  +--+--+--+--+  +--+  +--+--+--+--+  +
|                    |                                |           |        |                       |                    |                    |
+--+--+--+--+--+--+--+--+--+--+--+--+--+--+--+--+--+--+--+--+--+--+--+  +--+--+--+--+--+--+--+--+--+--+--+--+--+--+--+--+--+--+--+--+--+--+--+